########
###...##
#.A...##
###...##
#.##..##
#.#...##
#...B.G#
#......#
########


