########
###...##
#GAB..##
###.B.##
#G##B.##
#.#.G.##
#B.$B.G#
#...G..#
########

